16;16
1111111111111111
1000000000000001
1000000000000001
1000000000000001
1000000000000001
1010000000000001
1000000000000001
1000000000000001
1000000000000001
1000000000100001
1000000000000001
1000000000000001
1000000000000001
1000000000000001
1000000000000001
1111111111111111
