16;16
1111111111111111
1000000000000001
1001000000100001
1000000100100001
1000010010010001
1000000011000111
1001000000000011
1010101000000001
1000100010000001
1000000000000001
1001000000000001
1000000000100101
1000100001001001
1000100000000111
1001000001000001
1111111111111111
