17;17
11111111111111111
10000000000100001
10000000000000011
10001100000011101
10000000000010001
10000100000000001
10000000000000001
10000000000000001
10110000000000101
11101000000000001
10100100001100101
10000100000000101
11001100000000011
10000001010000001
10010001000101001
10001001000000111
11111111111111111
